3-7165+1
1-13227+1
1-22223+1
4-364+4
4-1692+1
4-3893+5
4-4775+2
4-8759+1
8-3030+1
8-11424+1
8-13328+1
11-8217+1
15-100+1
15-1046+1
15-1617+11
15-1864+4
15-1961+2
14-2072+1
14-4296+1
14-6722+1
16-2746+1
16-2896+1
16-5866+1
